1
BBBBBBBBBBBBBBB
BfffffffffffffB
BfBBBBBfBBBBBfB
BfBCCCBfBCCCBfB
BfBCBCBfBCBCBfB
BfffffffffffffB
BfBfBfBfBfBfBfB
BfffffffffffffB
BfBCBCBfBCBCBfB
BfBCCCBfBCCCBfB
BfBBBBBfBBBBBfB
BfffffffffffffB
BBBBBBBBBBBBBBB

